18-7
.OCC...TTT.......O
...T...TTT.....O..
.CC.T..T...CC.O...
..C........O...C..
@...T..O..........
..TC...TTT.......T
............O.....